Name	title	coding
t3_qqa0m5	Classes not being in person this winter....	c
t3_qrnmhc	starbucks w/ seating?	f
t3_qpd7vg	Is there free COVID testing for McGill students?	o
t3_qp1lnb	IPN Supervisor Hunt	o
t3_qrd10z	NOAH SCENTED MAYO SPOTTED AT TIPSY COW	o
t3_qplrde	Comp 598 students: Should res provide better vegetarian food options?	f
t3_qrtyq8	"Six months later, we are still demanding accountability for the McGill blacklist - SPHR"	o
t3_qodyxq	Wellness hub replacement?	o
t3_qrqr3m	ECON 468 study tips?	c
t3_qr9i24	How likely are class locations to change?	c
t3_qpknpx	PHIL 434 Midterm	c
t3_qpjb3c	Which advisor should I contact to talk about switching faculties?	o
t3_qrb74y	Mclennan/Redpath	o
t3_qqmzrs	How does taking a course or two at Concordia work?	c
t3_qq9hxp	Is there a difference between PSYC 395 and 494?	c
t3_qrruj0	how to do better on ENGL essays?	c
t3_qqwdur	Working at a residence dining hall?	o
t3_qrs16j	asking about McGill residence	r
t3_qr62ge	Leetcode club?	o
t3_qpo84a	How many days ahead do you typically start studying for a midterm?	c
t3_qr19q4	Can Profs remove rate my prof ratings/comments?	o
t3_qphbiq	Cloudberry Stocking Up for the Winter	o
t3_qp87j2	On-campus study spots with nice outside view ?	o
t3_qphbd3	DONE WITH HEALTH SERVICES	o
t3_qos56x	Quick SOCI235 Questions	c
t3_qr8mpn	I have seen a white squirrel outside of Mcgill	o
t3_qp884q	My only source for a reference doesn't want to be a reference - what to do?	o
t3_qpkoxu	"Anyone else getting constant ""Unexpected Server Response"" on mycourses when trying to access documents?"	o
t3_qp536l	BIOC 311. oh my god	c
t3_qor49v	How doable is it to take GERM325 and GERM336 in the same semester?	c
t3_qpma8y	How long does it take to get official transcripts?	o
t3_qov9br	Winter term at Udem?	o
t3_qru0ac	Describe to me your lecture crush	c
t3_qqrn2l	Feeling bummed knowing I donâ€™t got what it takes to make it to medicine	o
t3_qr2cq0	Religions of east Asia	o
t3_qrovl4	Metro stops	o
t3_qpo7rn	Harassed on the metro	o
t3_qqlli3	Anyone else gonna be an old ass undergrad?	o
t3_qownap	Lost Goggle	o
t3_qqx044	Reaching out to a professor?	o
t3_qpt94m	FINE 441 projects	c
t3_qqcxo7	How to review for Comp 250/273?	c
t3_qqd26j	Present thoughts (Rant)	o
t3_qphp3l	Hot chocolate	f
t3_qp6gu4	good news monday	o
t3_qpfm5z	Flags lowered in memory of deceased students: Cause of death?	o
t3_qr4ttx	"Found Cloudberry's nemesis, does he have a name?"	o
t3_qqzdrh	Class rank for MSc. application?	o
t3_qou8zc	fall 2021 SSMU referendum starts tomorrow!	o
t3_qovae6	Where to apply for summer internships CS?	o